0 1 0 0 0
0 2 0 0 5
1 0 0 0 9
2 2 0 0 9
5 0 0 0 0
0 0 3 0 5
0 4 4 0 5
3 3 3 0 3
0 0 9 0 9
0 0 0 1 0
0 0 0 2 9
0 5 0 2 5
9 0 0 2 9
4 4 4 2 4
0 0 0 0 0
0 0 0 0 0